....................
..C.................
.###................
....................
....................
....................
....................
...........CCC......
...........###......
......CCC...........
......###.......CCC.
..F.............###.
.###................
....................
####################
